F 200,100,20
C 200,100,20

NO bla
SO bla
EA bla
WE bla

1111111111
1000000001
1000000001
1000000001
1000000001
100W001001
1000001001
1001111001
1000000001
1111111111
