F 220,100,0

C 200,200,0


NO holaestoesunpath
SO      unpath
WE   path
EA ultimo path

                1
11111111       101
10W01001        1 
10010101
11111111




