F 220,100,0

C 200,200,0


NO holaestoesunpath
SO      unpath
WE   path
EA ultimo path

11111111
1000W001
10000001
11110111
