F 220,100,0


C 200,200,0




NO holaestoesunpath
SO      unpath
WE   path
EA ultimo path



1111111111111
1000000000001111
110000000N00111
 10000000001
 10011111111
1111111
100000011
10000011
1110111
  111



