NO h
SO h
EA h
WE h


F 2,0,9
C 2.3.4


11111111111111111111111111111111111111111111111
1111111111000000000011111111111110110000011111111
1111111111111111111111111111111111111111111111
              100000000000000000000000000000001
1111111111111                                 1
100000000000000000000000000000000000000000000001
1111111111111111111111111111111111111111111111111
