F 10,20,30
C 10,20,30



SO h
WE h
EA h
NO h

11111111
10000001
10000001
100W0001
10000001
10000001
10001001
10001001
11111111
