F 200,100,20
C 200,100,20

NO bla
SO bla
EA bla
WE bla

111111111
1000W0001
100000001
100010001
100000001
111111111
