F 10,20,30
C 10,20,30



SO h
WE h
EA h
NO h

1111111111111111
100010000W110001
1000100000000001
1000100000000001
1000000000010001
11111110000000011111
10000000000100000001
1000000000010000011
10000000000100001
1000000000010001
1000111111111001
1000000000010001
1000000000010001
1000000000010001
1000000000010001
1111111111111111
