F 220,100,0


C 200,200,0




NO holaestoesunpath
SO      unpath
WE   path
EA ultimo path

        1
       101
      10001
     1000001
    1000W0001
   10000000001
  1111111111111
